F 47,50,52
C 64,64,64

NO ./images/new_wall1.png
SO ./images/new_wall2.png
WE ./images/new_wall3.png
EA ./images/new_wall4.png
DO ./images/door.png

11111111111111111111
10000000000000000001
10000000000000000001
10000000000000000001
10000000000000000001
10000000000000000001
10000000000000000001
100000000000N0000001
10000000000000000001
10000000000000000001
10000000000000000001
10000000000000000001
11111111111111111111
