F 29,206,195
C 64,64,64

NO ./images/wall1.png
SO ./images/wall2.png
WE ./images/wall3.png
EA ./images/wall4.png
DO ./images/door.png

1111111111111111111111111111111111111111111111111111111111111111
1000010000010000000000010000000000000000000000000000000000000001
1000030000030000000000010000000000000000000000000000000000000001
1000010000010000000000010000000000000000000000000000000000000001
1111111311111111113111110000000000000000000000000000000000000001
1000000000000100000000010000000000000000000000000000000S00000001
1000000000000100000000010000000000000000000000000000000000000001
1000000000000100000000010000000000000000000000100000000000000001
1111111311111111113111111111111111113111111111111111111111111111
1003000000000300000000010000000000000000000000100000000000000001
1001000000000100000000000000000000000000000000300000000000000001
1001000000000100000000010000000000000000000000100000000000000001
1111111311111111113111111111111111113111111131113111111111111111
1000000000000000000000010000000000000000000000100000000000000001
1000000000000000000000010000000000000000000000300000000000000001
1000000000000000000000010000000000000000000000100000000000000001
1000000000000000000000010000000000000000000000100000000000000001
1000000000000000000000000000000000000000000000100000000000000001
1000000000000000000000010000000000000000000000100000000000000001
1000000000000000000000010000000000000000000000100000000000000001
1000000000000000000000010000000000000000000000100000000000000001
1111111111111111111111111111111111111111111111111111111111111111
