F 29,206,195
C 12,53,64

NO ./images/wall1.png
SO ./images/wall2.png
WE ./images/wall3.png
EA ./images/wall4.png
DO ./images/door.png

       111111111111111111111111111
1111111100010000000000000000000001
1100011000010000000000011111111111
100003000003000000000001
100001000001000000000001
111111131111111111311111
100000000000010000000001
100000000000010000000001
111111111000001000000001
        11111110111111111111111111111111111111111111111111111
        10030000000003000000000100000000000000000000000000001
        10010000000001000000000300000000000000000000000000001
        10010000000001000000000100000000000000000000000000001
1111111111111111113111111111111111111111111111111111111111111
100000000000000000000001
1000N0000000000000000001
100000000000000000000001
100000000000000000000001
100000000000000000000001
100000000000000000000001
100000000000000000000001
100000000000000000000001
111111111111111111111111
