F 34,23,45
F 255,0,0
C 64,64,64

NO ./images/wall1.png
SO ./images/wall2.png
WE ./images/wall3.png
EA ./images/wall4.png

111111     1111111111111
100001     1000000000001
10E001111111000000000001
100000000003000000000001
111111131111111111311111
100000000000010000000001
100000000000010000000001
100000000000010000000001
111111131111111111311111
100300001    00000000001
100100001    10000000001
100100001    10000000001
111111131111111111311111
100000000000000000000001
100000000000000000000001
100000000000000000000001
100000000000000000000001
100000000000000000000001
100000000000000000000001
100000000000000000000001
100000000000000000000001
111111111111111111111111
