NO ./images/bluestone.png
SO ./images/bluestone.png
WE ./images/bluestone.png
EA ./images/bluestone.png
DO ./images/new_door.png

F 64,64,100
C 64,64,64

1111111111111111111111111
1000000000001000000000001
1000000000701000000000001
1500005000053000000000001
1000000000001000000000001
1000000000001000000000001
1111113111111111111111111
    10501
    10001
    10001
    10001
    10001
    10501
  111000111
  170000061
  111000111
    10001
    10501
1111113111111
1000000000001111111111111111111111111111111
1000000000701000000000001000000000000000441
1500005000053000000000003000000000000000041
1000000000001000000000001000000000000000071
1000000000001110000000011000000000000000001
1111113111111111100011111111101111111011111
    105011111111100011111111111111111111111
    10001111111110001
    10001111111110001
    10001111111110001
    10001101001030001
    10001000000011111
    1000110100101
    1050111111111
    10701
    10001
    10001
    10701
    10001
    10001
    10501
1111113111111
1600100010001
1000305030001
1000100016001
1111100011111
1000100010001
10E0305030061
1000100010001
1111100011111
1005005005001
1600000000041
1111111111111
