1111111111111
10N0000001101
1000000110001
1001110000001
1001000000111
1000010000001
1000011110001
1000000000001
1000011000001
1000001110001
1000000000001
1000011110001
1111111111111
