F 29,206,195
C 64,64,64

NO ./images/wall1.png
SO ./images/wall2.png
WE ./images/wall3.png
EA ./images/wall4.png

111111111111111111111111
100001000001000000000001
100003000003000000000001
100001000001000000000001
111111131111111111311111
100000000000010000000001
100000000000010000000001
100000000000010000000001
111111131111111111311111
100300000000030000000001
10010000N000010000000001
100100000000010000000001
111111131111111111311111
100000000000000000000001
100000000000000000000001
100000000000000000000001
100000000000000000000001
100000000000000000000001
100000000000000000000001
100000000000000000000001
100000000000000000000001
111111111111111111111111
