111111111111111111111111
10E000022110000111110001
111001220000111011000101
110101111100100000011101
100000001110000110000101
111111110011000111111101
111000011110001100000001
100001110000110001110001
100110000001111110000001
100000011111100000000001
111100010000000000000001
100111111000000000000001
100000000000000000000001
111111111111111111111111
