F 29,206,195
C 64,64,64

NO ./images/wall.png
SO ./images/wall2.png
WE ./images/dice2.png
EA ./images/dice.png

111111111111111111111111
10E000022110000111110001
111001220000111011000101
110101111100100000011101
100000001110000110000101
111111110011000111111101
111000011110001100000001
100001110000110001110001
100110000001111110010001
100000011111100000010111
111100010001100011000001
100111111100000001111001
100000000011111100000001
111111111111111111111111
