F 47,50,52
C 64,64,64

NO ./images/new_wall1.png
SO ./images/new_wall2.png
WE ./images/new_wall3.png
EA ./images/new_wall4.png

111111111111111111111111
1S0030000000001000000001
100011111110001000100011
111110000000003000100011
111111111311111111111311
100000000001000000000001
100011111001000000000001
101110001001000000000001
100000000000000000000001
100000000000000000000001
100000000000000000000001
100000000000000000000001
100000000000000000000001
111111111111111111111111
