F 102,81,65
C 64,64,64

NO ./images/wall.png
SO ./images/wall2.png
WE ./images/dice2.png
EA ./images/dice.png

111111111111111111111111
1N0000000000000000000001
100000000000000000000001
100000000000000000000001
100000000000000000000001
100000000000000000000001
100000000000000000000001
100000000000000000000001
100000000000000000000001
100000000000000000000001
100000000000000000000001
100000000000000000000001
100000000000000000000001
111111111111111111111111
