11111111111111111
100000000P0000001
100001110000000C1
10000E000000E0011
11111111111111111
